date,actual_deaths,total_deaths,predicted_deaths_mean,predicted_deaths_lower,predicted_deaths_upper,predicted_total_deaths_mean,predicted_total_deaths_lower,predicted_total_deaths_upper,predicted_new_infected_mean,predicted_new_infected_lower,predicted_new_infected_upper,predicted_current_infected_mean,predicted_current_infected_lower,predicted_current_infected_upper,predicted_total_infected_mean,predicted_total_infected_lower,predicted_total_infected_upper,r_values_mean
2020-02-05,0,0,,,,,,,101,50,150,101,50,150,101,50,150,2.28820209762
2020-02-06,0,0,,,,,,,101,50,150,203,99,300,202,100,300,2.28800241321
2020-02-07,0,0,,,,,,,101,50,150,304,150,450,303,150,450,2.28795810954
2020-02-08,0,0,,,,,,,101,50,150,406,199,600,404,200,600,2.28790395942
2020-02-09,0,0,,,,,,,251,114,386,657,332,968,655,314,986,2.28783776786
2020-02-10,0,0,,,,,,,251,114,386,908,452,1348,906,428,1372,2.28775684793
2020-02-11,0,0,,,,,,,251,114,386,1159,570,1730,1157,542,1758,2.28765790961
2020-02-12,0,0,,,,,,,251,114,386,1410,687,2113,1408,656,2144,2.28753692303
2020-02-13,0,0,,,,,,,399,190,610,1809,899,2701,1807,846,2754,2.28738895026
2020-02-14,0,0,,,,,,,551,284,835,2359,1190,3529,2358,1130,3589,2.28719218788
2020-02-15,0,0,,,,,,,748,417,1100,3107,1629,4607,3106,1547,4689,2.28696874614
2020-02-16,0,0,,,,,,,1393,783,1898,4501,2517,6493,4499,2330,6587,2.28669127315
2020-02-17,0,0,,,,,,,2193,1359,3001,6694,3966,9416,6692,3689,9588,2.28635307069
2020-02-18,0,0,,,,,,,2531,1569,3491,9225,5563,12881,9223,5258,13079,2.28593989581
2020-02-19,0,0,,,,,,,3008,1947,4074,12233,7542,16921,12231,7205,17153,2.28543436002
2020-02-20,0,0,,,,,,,3109,2016,4213,15241,9511,20978,15340,9221,21366,2.28481462918
2020-02-21,0,0,,,,,,,3535,2292,4720,18675,11772,25525,18875,11513,26086,2.28405396335
2020-02-22,0,0,,,,,,,4443,2935,5908,23016,14688,31249,23318,14448,31994,2.28312142824
2020-02-23,0,0,,,,,,,5269,3529,6940,28184,18227,37995,28587,17977,38934,2.28197825888
2020-02-24,0,0,,,,,,,6307,4250,8379,34239,22416,45954,34894,22227,47313,2.28057577555
2020-02-25,0,0,,,,,,,9472,6099,12377,43461,28476,57740,44366,28326,59690,2.278853813
2020-02-26,0,0,,,,,,,11303,7478,14862,54512,35863,72149,55669,35804,74552,2.2767378979
2020-02-27,0,0,,,,,,,12222,8042,16205,66483,43788,87916,67891,43846,90757,2.27413672843
2020-02-28,0,0,,,,,,,14472,9523,19383,80556,53103,106621,82363,53369,110140,2.27093726066
2020-02-29,1,1,,,,,,,17115,10981,23322,97120,63778,128992,99478,64350,133462,2.26699898973
2020-03-01,0,1,,,,,,,21819,13764,30147,118191,77146,157864,121297,78114,163609,2.26214736986
2020-03-02,5,6,,,,,,,26833,16901,37441,143631,93317,193267,148130,95015,201050,2.25616563587
2020-03-03,1,7,,,,,,,32527,20441,45627,173965,112459,235786,180657,115456,246677,2.24878482288
2020-03-04,4,11,,,,,,,39052,24210,55003,210486,135158,287204,219709,139666,301680,2.23967104477
2020-03-05,1,12,,,,,,,47887,29426,67368,255365,162708,350435,267596,169092,369048,2.2284101496
2020-03-06,2,14,,,,,,,57763,34977,82032,310018,195764,428195,325359,204069,451080,2.21449035882
2020-03-07,3,17,,,,,,,69063,41646,98442,375546,235206,521888,394422,245715,549522,2.19728405475
2020-03-08,4,21,,,,,,,81793,49735,116376,452897,282059,632408,476215,295450,665898,2.17603199454
2020-03-09,1,22,,,,,,,96061,59415,137869,543689,337960,763426,572276,354865,803767,2.14983654737
2020-03-10,6,28,,,,,,,112181,70975,161657,649563,404667,916845,684457,425840,965424,2.11767598042
2020-03-11,5,33,,,,,,,128465,82605,183414,768556,481239,1087899,812922,508445,1148838,2.07845764215
2020-03-12,10,43,,,,,,,144561,96229,199209,901815,569947,1272313,957483,604674,1348047,2.0311302281
2020-03-13,9,52,,,,,,,160157,106602,216435,1049749,668440,1472525,1117640,711276,1564482,1.97486761254
2020-03-14,6,58,,,,,,,174522,122146,228197,1209799,780988,1681176,1292162,833422,1792679,1.90931223378
2020-03-15,12,70,,,,,,,187831,134902,252091,1380515,904891,1909861,1479993,968324,2044770,1.83482739946
2020-03-16,27,97,,,,,,,199685,146672,261084,1558381,1037947,2140636,1679678,1114996,2305854,1.75267445621
2020-03-17,34,131,,,,,,,210130,154967,273936,1741678,1176290,2376966,1889808,1269963,2579790,1.66503040798
2020-03-18,57,188,,,,,,,219311,164257,287345,1928461,1320471,2618522,2109119,1434220,2867135,1.57480508846
2020-03-19,76,264,,,,,,,227327,171659,298693,2116736,1468214,2862013,2336446,1605879,3165828,1.48528350905
2020-03-20,97,361,,,,,,,234381,179173,306739,2303231,1618310,3101142,2570827,1785052,3472567,1.39967524664
2020-03-21,94,455,,,,,,,240483,186704,313250,2485951,1770554,3332155,2811310,1971756,3785817,1.32068009224
2020-03-22,145,600,,,,,,,245689,191123,319843,2662577,1920395,3553362,3056999,2162879,4105660,1.25017462173
2020-03-23,183,783,,,,,,,250084,194875,324916,2830868,2065897,3761796,3307083,2357754,4430576,1.18908808179
2020-03-24,237,1020,,,,,,,253709,198705,327070,2988516,2205398,3950973,3560792,2556459,4757646,1.13747461465
2020-03-25,312,1332,,,,,,,256617,201962,329040,3132952,2336408,4118374,3817409,2758421,5086686,1.09472610192
2020-03-26,413,1745,,,,,,,258835,204921,331509,3263322,2458580,4266594,4076244,2963342,5418195,1.05983718956
2020-03-27,552,2297,,,,,,,260378,207069,331382,3379138,2569228,4398755,4336622,3170411,5749577,1.03164407257
2020-03-28,634,2931,,,,,,,261269,208446,330556,3480250,2670664,4512821,4597891,3378857,6080133,1.00899531407
2020-03-29,627,3558,,,,,,,261555,209465,328693,3567284,2757901,4613245,4859446,3588322,6408826,0.990849624667
2020-03-30,820,4378,,,,,,,261210,210334,326308,3640663,2833336,4687550,5120656,3798656,6735134,0.976316521618
2020-03-31,1224,5602,,,,,,,260299,210606,324718,3701277,2897517,4751200,5380955,4009262,7059852,0.964660963854
2020-04-01,1241,6843,,,,,,,258859,210542,322014,3750006,2953435,4799407,5639814,4219804,7381866,0.955289437271
2020-04-02,1586,8429,,,,,,,256937,209515,318719,3787632,2998930,4830967,5896751,4429319,7700585,0.947728949732
2020-04-03,1315,9744,,,,,,,254579,207072,314546,3814884,3034178,4846945,6151330,4636391,8015131,0.941605253869
2020-04-04,1284,11028,,,,,,,251830,204872,309961,3832332,3059575,4850165,6403160,4841263,8325092,0.936623202546
2020-04-05,1439,12467,,,,,,,248741,202115,306039,3840590,3074824,4843096,6651901,5043378,8631131,0.932550212031
2020-04-06,1668,14135,,,,,,,245364,199767,301802,3840264,3083150,4825173,6897265,5243145,8932933,0.929202858527
2020-04-07,2309,16444,,,,,,,241749,197419,296765,3831929,3085409,4797180,7139014,5440564,9229698,0.926436241969
2020-04-08,2116,18560,,,,,,,237945,193459,291379,3816165,3079784,4761610,7376959,5634023,9521077,0.924135641872
2020-04-09,2075,20635,,,,,,,233999,189516,286199,3793548,3066838,4718846,7610958,5823539,9807276,0.92221000768
2020-04-10,2093,22728,,,,,,,229953,185892,280907,3764666,3047321,4668359,7840911,6009431,10088183,0.920586890389
2020-04-11,2046,24774,,,,,,,225844,182380,275500,3730132,3022278,4612625,8066755,6191811,10363683,0.919208495626
2020-04-12,1774,26548,,,,,,,221699,179167,269894,3690563,2992779,4552136,8288454,6370978,10633577,0.918028605495
2020-04-13,1828,28376,,,,,,,217545,175992,264632,3646553,2959209,4488230,8505999,6546970,10898209,0.917010172467
2020-04-14,2404,30780,,,,,,,213400,172358,258441,3598742,2921230,4420481,8719399,6719328,11156650,0.916123433446
2020-04-15,2549,33329,,,,,,,209278,168778,253676,3547721,2879425,4349562,8928677,6888106,11410326,0.915207914103
2020-04-16,2113,35442,,,,,,,205193,165593,248784,3494055,2834473,4276482,9133870,7053699,11659110,0.914430366992
2020-04-17,2614,38056,,,,,,,201154,162421,243514,3438272,2787369,4201402,9335024,7216120,11902624,0.91379714077
2020-04-18,2386,40442,,,,,,,197171,159333,238909,3380864,2739635,4125868,9532195,7375453,12141533,0.91331504357
2020-04-19,1229,41671,,,,,,,193246,156257,234353,3322280,2691022,4050312,9725441,7531710,12375886,0.912914391527
2020-04-20,1795,43466,,,,,,,189385,153078,229686,3262925,2641998,3974031,9914826,7684788,12605572,0.912552592116
2020-04-21,2453,45919,,,,,,,185592,149785,225169,3203153,2591986,3897451,10100418,7834573,12830741,0.912227061455
2020-04-22,2393,48312,,,,,,,181870,146534,220739,3143274,2541021,3821456,10282288,7981107,13051480,0.911916123253
2020-04-23,2434,50746,,,,,,,178219,143327,216308,3083548,2490795,3746407,10460507,8124434,13267788,0.911632669064
2020-04-24,2118,52864,,,,,,,174642,140010,212249,3024191,2441242,3672465,10635149,8264444,13480037,0.911410355924
2020-04-25,1650,54514,,,,,,,171141,136792,208266,2965379,2392108,3599826,10806290,8401236,13688303,0.911245793706
2020-04-26,1293,55807,,,,,,,167720,133694,204376,2907256,2343400,3528710,10974010,8534930,13892679,0.911142191068
2020-04-27,1423,57230,,,,,,,164381,130870,200688,2849937,2295078,3459510,11138391,8665800,14093367,0.911084662185
2020-04-28,2221,59451,,,,,,,161124,128173,196972,2793516,2247234,3391843,11299515,8793973,14290339,0.911080663479
2020-04-29,2501,61952,,,,,,,157953,125371,193480,2738069,2200229,3326886,11457468,8919344,14483819,0.9111391617
2020-04-30,2301,64253,,,,,,,154873,122399,190089,2683664,2153839,3263300,11612341,9041743,14673908,0.911265523616
2020-05-01,1869,66122,,,,,,,151881,119551,186806,2630353,2107786,3201324,11764222,9161294,14860714,0.911481424756
2020-05-02,1556,67678,,,,,,,148980,116861,183630,2578178,2062213,3141447,11913202,9278155,15044344,0.911801311651
2020-05-03,1096,68774,,,,,,,146173,114387,180400,2527181,2017258,3082939,12059375,9392542,15224744,0.912239473298
2020-05-04,1309,70083,,,,,,,143465,111811,177220,2477401,1972802,3025794,12202840,9504353,15401964,0.912812601074
2020-05-05,2307,72390,,,,,,,140857,109456,174311,2428872,1929169,2970415,12343697,9613809,15576275,0.913540042292
2020-05-06,2458,74848,,,,,,,138352,107230,171687,2381632,1886606,2916927,12482049,9721039,15747962,0.914442825923
2020-05-07,1919,76767,,,,,,,135953,105148,169113,2335716,1845216,2865295,12618002,9826187,15917075,0.915542301494
2020-05-08,1727,78494,,,,,,,133665,103204,166722,2291161,1805096,2815702,12751667,9929391,16083797,0.916859050143
2020-05-09,1479,79973,,,,,,,131489,101186,164418,2248008,1766283,2767867,12883156,10030577,16248215,0.918411491111
2020-05-10,879,80852,,,,,,,129430,99215,162225,2206296,1728724,2721826,13012586,10129792,16410440,0.920214264097
2020-05-11,1013,81865,,,,,,,127491,97435,160101,2166066,1692480,2677552,13140077,10227227,16570541,0.922276561782
2020-05-12,1612,83477,,,,,,,125674,95892,158213,2127360,1657513,2635072,13265751,10323119,16728754,0.924600686552
2020-05-13,1754,85231,,,,,,,123983,94334,156253,2090219,1623683,2594349,13389734,10417453,16885007,0.92718117857
2020-05-14,1774,87005,,,,,,,122422,92938,154449,2054688,1591261,2555321,13512156,10510391,17039456,0.930004868739
2020-05-15,1661,88666,,,,,,,120992,91632,152852,2020807,1560504,2518090,13633148,10602023,17192308,0.933052113508
2020-05-16,1223,89889,,,,,,,119698,90391,151343,1988624,1531358,2482635,13752846,10692414,17343651,0.936299250807
2020-05-17,752,90641,,,,,,,118541,89328,149936,1958185,1503840,2448953,13871387,10781742,17493587,0.939722044848
2020-05-18,770,91411,,,,,,,117526,88440,148665,1929538,1477908,2417225,13988913,10870182,17642252,0.943299586958
2020-05-19,1551,92962,,,,,,,116654,87690,147597,1902727,1453799,2387600,14105567,10957872,17789849,0.947017925886
2020-05-20,1563,94525,,,,,,,115929,87056,146758,1877799,1431409,2360046,14221496,11044928,17936607,0.950872712105
2020-05-21,1228,95753,,,,,,,115355,86580,146133,1854802,1410772,2334494,14336851,11131508,18082740,0.954870276478
2020-05-22,1269,97022,,,,,,,114935,86263,145645,1833784,1391901,2311030,14451786,11217771,18228385,0.959026845299
2020-05-23,1121,98143,,,,,,,114676,86021,145293,1814795,1374732,2289603,14566462,11303792,18373678,0.963365905275
2020-05-24,608,98751,,,,,,,114581,85975,145165,1797887,1359536,2270355,14681043,11389767,18518843,0.967914015948
2020-05-25,513,99264,,,,,,,114659,86052,145239,1783117,1346388,2253376,14795702,11475819,18664082,0.97269559646
2020-05-26,685,99949,,,,,,,114917,86315,145489,1770544,1335283,2238765,14910619,11562134,18809571,0.977727384006
2020-05-27,1509,101458,,,,,,,115359,86698,145851,1760229,1326101,2226402,15025978,11648832,18955422,0.983013381325
2020-05-28,1182,102640,,,,,,,115982,87284,146619,1752227,1319065,2216761,15141960,11736116,19102041,0.988541159022
2020-05-29,1166,103806,,,,,,,116798,87933,147607,1746603,1314074,2209909,15258758,11824049,19249648,0.994280303583
2020-05-30,964,104770,,,,,,,117813,88800,148792,1743424,1311257,2205835,15376571,11912849,19398440,1.00018354987
2020-05-31,591,105361,,,,,,,119033,89814,150116,1742759,1310693,2204592,15495604,12002663,19548556,1.0061906916
2020-06-01,772,106133,,,,,,,120453,91041,151764,1744671,1312419,2206400,15616057,12093704,19700320,1.01223479339
2020-06-02,1033,107166,,,,,,,122083,92346,153787,1749228,1316339,2211495,15738140,12186050,19854107,1.01824968546
2020-06-03,990,108156,,,,,,,123926,93866,155949,1756500,1322527,2219816,15862066,12279916,20010056,1.02417738676
2020-06-04,1009,109165,,,,,,,125974,95328,158438,1766544,1330810,2231457,15988040,12375244,20168494,1.02997410013
2020-06-05,970,110135,,,,,,,128236,97018,161188,1779425,1341269,2246473,16116276,12472262,20329682,1.03561375308
2020-06-06,680,110815,,,,,,,130714,98833,164254,1795205,1353870,2265049,16246990,12571095,20493936,1.0410885998
2020-06-07,451,111266,,,,,,,133412,100642,167706,1813940,1368525,2287426,16380402,12671737,20661642,1.04640697584
2020-06-08,505,111771,,,,,,,136318,102614,171531,1835677,1385198,2313756,16516720,12774351,20833173,1.05158875838
2020-06-09,940,112711,,,,,,,139439,104607,175572,1860457,1403790,2344051,16656159,12878958,21008745,1.05665936711
2020-06-10,917,113628,,,,,,,142782,107060,180037,1888321,1424572,2378573,16798941,12986018,21188782,1.06164325609
2020-06-11,881,114509,,,,,,,146344,109466,184980,1919306,1447370,2417677,16945285,13095484,21373762,1.06655784389
2020-06-12,822,115331,,,,,,,150082,111819,190248,1953406,1471944,2461295,17095367,13207303,21564010,1.07140874389
2020-06-13,750,116081,,,,,,,153942,114240,195848,1990551,1498299,2509537,17249309,13321543,21759858,1.07618698955
2020-06-14,298,116379,,,,,,,158013,116846,201934,2030750,1526391,2562686,17407322,13438389,21961792,1.0808686798
2020-06-15,391,116770,,,,,,,162285,119216,208106,2074002,1555827,2620687,17569607,13557605,22169898,1.0854170914
2020-06-16,839,117609,,,,,,,166660,121598,214706,2120209,1586415,2683654,17736267,13679203,22384604,1.08856668478
2020-06-17,751,118360,,,,,,,171115,123859,221284,2169241,1617948,2751183,17907382,13803062,22605888,1.09149514715
2020-06-18,704,119064,,,,,,,175715,126553,228292,2221029,1650643,2823566,18083097,13929615,22834180,1.09415692033
2020-06-19,672,119736,,,,,,,180435,129193,235494,2275490,1684512,2900669,18263532,14058808,23069674,1.09651354535
2020-06-20,610,120346,,,,,,,185283,131743,243021,2332537,1719233,2982552,18448815,14190551,23312695,1.09853754937
2020-06-21,255,120601,,,,,,,190230,134187,250871,2392053,1754581,3069214,18639045,14324738,23563566,1.10021408894
2020-06-22,406,121007,,,,,,,195242,136531,258495,2453884,1790463,3160041,18834287,14461269,23822061,1.10154087457
2020-06-23,837,121844,,,,,,,200327,138861,266557,2517893,1826696,3255096,19034614,14600130,24088618,1.10252672374
2020-06-24,757,122601,,,,,,,205490,141291,275189,2583944,1863364,3354736,19240104,14741421,24363807,1.10318921075
2020-06-25,2422,125023,,,,,,,210727,143358,283964,2651890,1899638,3458686,19450831,14884779,24647771,1.10355209327
2020-06-26,605,125628,,,,,,,215994,145469,292733,2721540,1935610,3566453,19666825,15030248,24940504,1.10364284759
2020-06-27,489,126117,,,,,,,221306,147678,301867,2792764,1971451,3678085,19888131,15177926,25242371,1.10349052738
2020-06-28,240,126357,,,,,,,226654,149985,311041,2865476,2007185,3793285,20114785,15327911,25553412,1.10312409771
2020-06-29,351,126708,,,,,,,232034,151860,320278,2939497,2042183,3911635,20346819,15479771,25873690,1.1025712189
2020-06-30,721,127429,,,,,,,237400,153407,329982,3014612,2076348,4033516,20584219,15633178,26203672,1.10185747034
2020-07-01,673,128102,,,,,,,242778,154997,338891,3090730,2109724,4157700,20826997,15788175,26542563,1.09916503496
2020-07-02,698,128800,,,,,,,248064,156593,348117,3167680,2142432,4284526,21075061,15944768,26890680,1.09640117482
2020-07-03,639,129439,,,,,,,253340,158070,357632,3245305,2173908,4413859,21328401,16102838,27248312,1.09357275236
2020-07-04,247,129686,,,,,,,258591,159473,366839,3323462,2204142,4545194,21586992,16262311,27615151,1.09070085565
2020-07-05,271,129957,,,,,,,263801,161020,376396,3401979,2233368,4678556,21850793,16423331,27991547,1.08781044811
2020-07-06,325,130282,,,,,,,268917,162432,386444,3480667,2261562,4814117,22119710,16585763,28377991,1.08495048064
2020-07-07,1195,131477,,,,,,,273915,163691,396562,3559340,2288674,4952174,22393625,16749454,28774553,1.08208425411
2020-07-08,820,132297,,,,,,,278836,164990,406928,3637849,2314757,5092536,22672461,16914444,29181481,1.07923888345
2020-07-09,990,133287,,,,,,,283674,165794,417104,3716033,2339215,5234446,22956135,17080238,29598585,1.07641917626
2020-07-10,802,134089,,,,,,,288364,166496,426595,3793670,2362314,5377081,23244499,17246734,30025180,1.07362950613
2020-07-11,685,134774,,,,,,,292934,167184,436486,3870610,2383998,5520837,23537433,17413918,30461666,1.07088164841
2020-07-12,428,135202,,,,,,,297368,167780,446872,3946672,2404080,5665835,23834801,17581698,30908538,1.0681728526
2020-07-13,361,135563,,,,,,,301669,168547,457388,4021687,2422633,5812163,24136470,17750245,31365926,1.06550261992
2020-07-14,900,136463,,,,,,,305829,169011,467514,4095482,2439786,5959373,24442299,17919256,31833440,1.0628714443
2020-07-15,,,659,450,893,137122,136913,137356,309834,169403,477080,4167916,2455783,6106445,24752133,18088659,32310520,
2020-07-16,,,669,453,911,137791,137366,138266,313681,169578,485871,4238819,2470368,6253404,25065814,18258237,32796391,
2020-07-17,,,680,456,931,138471,137823,139197,317279,169661,496623,4308034,2483439,6401881,25383093,18427898,33293014,
2020-07-18,,,692,461,952,139163,138285,140148,320704,169688,506491,4375398,2495060,6550707,25703797,18597586,33799505,
2020-07-19,,,704,465,973,139867,138750,141120,323954,169645,516267,4440760,2505236,6700105,26027751,18767231,34315772,
2020-07-20,,,716,469,995,140582,139220,142115,327013,169429,525177,4503973,2513646,6848872,26354764,18936660,34840949,
2020-07-21,,,728,472,1019,141310,139693,143133,329871,169284,534935,4564927,2520491,6997357,26684635,19105944,35375884,
2020-07-22,,,741,475,1040,142051,140168,144172,332509,168972,545783,4623521,2525765,7146557,27017144,19274916,35921667,
2020-07-23,,,753,478,1063,142804,140647,145234,334939,168512,555349,4679623,2529281,7294945,27352083,19443428,36477016,
2020-07-24,,,766,480,1086,143570,141128,146319,337146,167937,563796,4733096,2531417,7441610,27689229,19611365,37040812,
2020-07-25,,,778,483,1109,144348,141612,147427,339142,167411,573864,4783873,2532322,7588851,28028371,19778776,37614676,
2020-07-26,,,790,485,1132,145139,142099,148558,340921,166667,582340,4831860,2531798,7734670,28369292,19945443,38197016,
2020-07-27,,,803,488,1157,145941,142588,149714,342479,165850,591172,4876971,2529864,7878932,28711771,20111293,38788188,
2020-07-28,,,815,491,1183,146756,143079,150895,343816,164993,600539,4919118,2526311,8022029,29055587,20276286,39388727,
2020-07-29,,,828,493,1210,147584,143574,152105,344930,164000,607888,4958219,2521303,8162360,29400517,20440286,39996615,
2020-07-30,,,840,495,1238,148425,144070,153342,345828,162977,614910,4994212,2514882,8300166,29746345,20603263,40611525,
2020-07-31,,,853,497,1265,149277,144569,154606,346507,161801,621693,5027039,2507107,8435992,30092852,20765064,41233218,
2020-08-01,,,865,498,1290,150142,145068,155895,346974,160796,628375,5056733,2498246,8567735,30439826,20925860,41861593,
2020-08-02,,,876,499,1318,151018,145568,157211,347226,159856,634946,5083255,2488423,8696187,30787052,21085716,42496539,
2020-08-03,,,887,500,1346,151905,146069,158556,347265,158851,640891,5106567,2477640,8820820,31134317,21244567,43137430,
2020-08-04,,,898,501,1374,152803,146572,159928,347099,157689,646051,5126652,2465908,8941716,31481416,21402256,43783481,
2020-08-05,,,908,501,1400,153712,147074,161327,346733,156474,650758,5143513,2453100,9057583,31828149,21558730,44434239,
2020-08-06,,,918,501,1423,154630,147576,162748,346164,155325,654619,5157168,2439452,9166447,32174313,21714055,45088858,
2020-08-07,,,928,501,1451,155558,148079,164197,345397,154023,659612,5167626,2424957,9270734,32519710,21868078,45748470,
2020-08-08,,,937,500,1477,156494,148580,165673,344436,152712,663414,5174916,2409723,9370395,32864146,22020790,46411884,
2020-08-09,,,945,499,1503,157439,149080,167174,343289,151375,666275,5179063,2393673,9462837,33207435,22172165,47078159,
2020-08-10,,,953,498,1527,158392,149580,168700,341963,149996,669303,5180105,2376983,9549822,33549398,22322161,47747462,
2020-08-11,,,960,497,1552,159352,150078,170250,340456,148517,671616,5178082,2359630,9630282,33889854,22470678,48419078,
2020-08-12,,,966,496,1580,160318,150575,171828,338771,146955,673308,5173037,2341573,9703062,34228625,22617633,49092386,
2020-08-13,,,972,494,1605,161290,151070,173430,336924,145387,674523,5165032,2322944,9769709,34565549,22763020,49766909,
2020-08-14,,,977,491,1628,162267,151563,175057,334919,143718,675308,5154123,2303670,9830117,34900468,22906738,50442217,
2020-08-15,,,982,490,1654,163250,152054,176708,332764,142046,675365,5140380,2283898,9883797,35233232,23048784,51117582,
2020-08-16,,,987,487,1678,164237,152542,178384,330457,140423,674843,5123863,2263510,9930273,35563689,23189207,51792425,
2020-08-17,,,991,484,1701,165228,153027,180083,328009,138787,673997,5104647,2242433,9969326,35891698,23327994,52466422,
2020-08-18,,,994,482,1725,166222,153510,181805,325425,137186,672759,5082807,2220766,10001195,36217123,23465180,53139181,
2020-08-19,,,997,479,1749,167219,153990,183551,322712,135532,670911,5058420,2198610,10026044,36539835,23600712,53810092,
2020-08-20,,,1000,475,1768,168219,154467,185316,319871,133880,668676,5031559,2176022,10043941,36859706,23734592,54478768,
2020-08-21,,,1001,472,1786,169220,154940,187099,316913,132240,665806,5002308,2152942,10055104,37176619,23866832,55144574,
2020-08-22,,,1003,468,1805,170223,155410,188901,313843,130542,663662,4970753,2129467,10059133,37490462,23997374,55808236,
2020-08-23,,,1004,466,1823,171227,155877,190722,310667,128869,661666,4936984,2105631,10057364,37801129,24126243,56469902,
2020-08-24,,,1005,463,1841,172231,156341,192560,307800,127441,659680,4901495,2081704,10050749,38108929,24253684,57129582,
2020-08-25,,,1005,460,1858,173236,156803,194415,304832,125941,657113,4864365,2057653,10038543,38413761,24379625,57786695,
2020-08-26,,,1004,457,1872,174241,157261,196284,301788,124469,654726,4825697,2033608,10021643,38715549,24504094,58441421,
2020-08-27,,,1003,453,1885,175244,157716,198166,298692,123015,652410,4785617,2009667,10000736,39014241,24627109,59093831,
2020-08-28,,,1002,450,1898,176246,158167,200061,295586,121629,648644,4744279,1985909,9974857,39309827,24748738,59742475,
2020-08-29,,,1000,446,1911,177245,158615,201968,292521,120300,645176,4701881,1962491,9944717,39602348,24869038,60387651,
2020-08-30,,,997,442,1921,178242,159059,203886,289468,118943,640297,4658585,1939389,9909637,39891816,24987981,61027948,
2020-08-31,,,994,439,1929,179236,159499,205812,286408,117706,635962,4614536,1916673,9870742,40178224,25105687,61663910,
2020-09-01,,,990,435,1937,180226,159935,207746,283342,116463,630824,4569868,1894350,9827555,40461566,25222150,62294734,
2020-09-02,,,986,430,1944,181212,160367,209687,280275,115215,624510,4524718,1872381,9779300,40741841,25337365,62919244,
2020-09-03,,,981,426,1949,182193,160794,211633,277229,114100,618413,4479236,1850953,9726786,41019070,25451465,63537657,
2020-09-04,,,976,422,1953,183169,161217,213582,274205,112965,611912,4433569,1830041,9670005,41293275,25564430,64149569,
2020-09-05,,,970,417,1954,184139,161635,215533,271204,111948,605827,4387860,1809751,9610004,41564479,25676378,64755396,
2020-09-06,,,964,412,1954,185103,162049,217485,268228,110975,601178,4342246,1790182,9547502,41832707,25787353,65356574,
2020-09-07,,,958,407,1953,186061,162457,219434,265276,109966,595926,4296854,1771278,9481744,42097983,25897319,65952500,
2020-09-08,,,951,403,1950,187011,162861,221381,262354,108918,590289,4251408,1752753,9412333,42360337,26006237,66542789,
2020-09-09,,,943,398,1947,187955,163261,223325,259464,107889,585465,4206040,1734706,9340668,42619801,26114126,67128254,
2020-09-10,,,936,393,1942,188891,163656,225263,256612,106947,580405,4160864,1717188,9266347,42876413,26221073,67708659,
2020-09-11,,,928,389,1937,189819,164046,227196,253799,106039,575334,4115971,1700219,9189282,43130212,26327112,68283993,
2020-09-12,,,920,384,1929,190739,164432,229121,251026,105118,569640,4071411,1683717,9110298,43381238,26432230,68853633,
2020-09-13,,,912,379,1923,191651,164813,231041,248298,104303,563151,4027187,1667729,9028290,43629536,26536533,69416784,
2020-09-14,,,904,375,1919,192554,165189,232956,245618,103549,555308,3983337,1652341,8943307,43875154,26640082,69972092,
2020-09-15,,,895,370,1912,193449,165561,234864,242988,102764,547579,3939917,1637403,8854911,44118142,26742846,70519671,
2020-09-16,,,886,366,1905,194336,165929,236765,240409,102078,539514,3896984,1623023,8763573,44358551,26844924,71059185,
2020-09-17,,,878,362,1898,195213,166292,238659,237885,101277,531942,3854594,1609092,8670974,44596436,26946201,71591127,
2020-09-18,,,869,358,1889,196082,166651,240543,235418,100680,524929,3812782,1595678,8577440,44831854,27046881,72116056,
2020-09-19,,,860,354,1880,196942,167006,242420,233010,99856,515559,3771587,1582571,8480980,45064864,27146737,72631615,
2020-09-20,,,851,349,1870,197793,167357,244285,230662,99059,510083,3731045,1569676,8385147,45295526,27245796,73141698,
2020-09-21,,,842,346,1856,198635,167705,246137,228375,98293,504893,3691192,1556981,8288794,45523901,27344089,73646591,
2020-09-22,,,833,342,1843,199468,168049,247975,226154,97677,499658,3652070,1544679,8192477,45750055,27441766,74146249,
2020-09-23,,,825,338,1828,200293,168389,249798,223999,96945,494552,3613715,1532689,8096709,45974054,27538711,74640801,
2020-09-24,,,816,335,1810,201109,168725,251604,221911,96037,487978,3576162,1520832,7999214,46195965,27634748,75128779,
2020-09-25,,,807,331,1793,201916,169058,253392,219893,95290,481399,3539442,1509170,7900223,46415858,27730038,75610178,
2020-09-26,,,798,328,1776,202714,169388,255163,217948,94693,472783,3503591,1497819,7797693,46633806,27824731,76082961,
2020-09-27,,,790,325,1758,203503,169715,256917,216077,94023,466628,3468642,1486723,7694712,46849883,27918754,76549589,
2020-09-28,,,781,322,1745,204285,170039,258657,214281,93288,460941,3434625,1475703,7592530,47064164,28012042,77010530,
2020-09-29,,,773,320,1731,205057,170361,260383,212562,92518,454889,3401569,1464668,7492120,47276726,28104560,77465419,
2020-09-30,,,764,316,1716,205821,170679,262093,210924,91696,448798,3369505,1453598,7393321,47487650,28196256,77914217,
2020-10-01,,,756,313,1700,206577,170995,263788,209364,90452,443846,3338460,1441960,7297597,47697014,28286708,78358063,
2020-10-02,,,748,311,1687,207325,171307,265470,207883,89627,437700,3308458,1430301,7203258,47904897,28376335,78795763,
2020-10-03,,,740,308,1672,208064,171618,267137,206477,88979,432927,3279516,1418591,7111132,48111374,28465314,79228690,
2020-10-04,,,732,305,1654,208796,171925,268786,205149,88206,428473,3251655,1406931,7023882,48316523,28553520,79657163,
2020-10-05,,,724,303,1636,209519,172230,270417,203900,87367,424189,3224894,1395231,6937838,48520423,28640887,80081352,
2020-10-06,,,716,301,1615,210235,172533,272026,202730,86676,421708,3199248,1383607,6854558,48723153,28727563,80503060,
2020-10-07,,,708,298,1592,210944,172834,273613,201636,86098,419361,3174730,1372028,6774210,48924789,28813661,80922421,
2020-10-08,,,701,296,1568,211645,173133,275176,200614,85328,416032,3151346,1360410,6695652,49125403,28898989,81338453,
2020-10-09,,,694,294,1547,212338,173429,276717,199664,84346,412153,3129099,1348723,6619822,49325067,28983335,81750606,
2020-10-10,,,687,292,1527,213025,173724,278238,198791,83480,410116,3107998,1336915,6548651,49523858,29066815,82160722,
2020-10-11,,,680,290,1500,213704,174016,279732,197995,82585,408256,3088045,1324808,6484225,49721853,29149400,82568978,
2020-10-12,,,673,287,1484,214377,174306,281210,197273,81653,406315,3069242,1312438,6424014,49919126,29231053,82975293,
2020-10-13,,,666,285,1469,215043,174594,282673,196618,80630,404066,3051580,1299779,6367232,50115744,29311683,83379359,
2020-10-14,,,660,283,1458,215703,174880,284124,196033,79741,402949,3035050,1287001,6315370,50311777,29391424,83782308,
2020-10-15,,,654,281,1441,216357,175164,285559,195520,78923,402501,3019647,1274227,6269146,50507297,29470347,84184809,
2020-10-16,,,648,279,1423,217005,175445,286975,195079,78264,403127,3005362,1262041,6228489,50702376,29548611,84587936,
2020-10-17,,,642,277,1404,217646,175725,288372,194706,77597,403609,2992185,1250013,6194432,50897082,29626208,84991545,
2020-10-18,,,636,275,1380,218283,176002,289744,194396,76819,404781,2980105,1237850,6166328,51091478,29703027,85396326,
2020-10-19,,,631,273,1362,218913,176278,291099,194149,76257,404711,2969105,1225896,6142584,51285627,29779284,85801037,
2020-10-20,,,626,271,1346,219539,176551,292438,193966,75554,403921,2959171,1214079,6122316,51479593,29854838,86204958,
2020-10-21,,,621,268,1330,220160,176823,293761,193849,74766,405100,2950289,1202163,6105739,51673442,29929604,86610058,
2020-10-22,,,616,266,1312,220776,177091,295065,193792,74096,406784,2942446,1190166,6093213,51867234,30003700,87016842,
2020-10-23,,,611,263,1299,221387,177357,296356,193794,73362,407692,2935626,1178205,6084932,52061028,30077062,87424534,
2020-10-24,,,607,260,1281,221994,177620,297629,193853,72530,408965,2929814,1166392,6081789,52254881,30149592,87833499,
2020-10-25,,,603,258,1268,222597,177881,298888,193971,71855,409563,2924994,1154776,6081309,52448852,30221447,88243062,
2020-10-26,,,599,256,1255,223197,178140,300134,194144,71158,409903,2921143,1143358,6082998,52642996,30292605,88652965,
2020-10-27,,,596,254,1242,223792,178396,301367,194372,70504,411588,2918242,1132216,6088283,52837368,30363109,89064553,
2020-10-28,,,592,252,1236,224384,178650,302594,194651,69862,413378,2916275,1121456,6097611,53032019,30432971,89477931,
2020-10-29,,,589,250,1227,224973,178903,303812,194981,69296,415386,2915223,1111014,6110047,53227000,30502267,89893317,
2020-10-30,,,586,248,1219,225559,179154,305021,195362,68609,418078,2915065,1100697,6125623,53422362,30570876,90311395,
2020-10-31,,,583,245,1209,226142,179401,306221,195796,67921,420246,2915782,1090356,6142753,53618158,30638797,90731641,
2020-11-01,,,581,243,1202,226723,179647,307413,196281,67279,422126,2917357,1080038,6161284,53814439,30706076,91153767,
